0000000000000000
0000000000000000
0000000000000000
0000011100000000
0000014100000000
0000012111100000
0001113234100000
0001423511100000
0001111310000000
0000001410000000
0000001110000000
0000000000000000
0000000000000000
0000000000000000
0000000000000000
0000000000000000

