0000000000000000
0000000000000000
0011111111100000
0012211222100000
0012223222100000
0013211123100000
0012144412100000
0112144412110000
0123223223210000
0122222122510000
0111111111110000
0000000000000000
0000000000000000
0000000000000000
0000000000000000
0000000000000000