0000000000000000
0000000000000000
0000000000000000
0000011111110000
0000112212510000
0000122213210000
0000132232210000
0000123112210000
0011123212110000
0014444422100000
0011111111100000
0000000000000000
0000000000000000
0000000000000000
0000000000000000
0000000000000000
