0000000000000000
0000000000000000
0000000000000000
0000000000000000
0000011111100000
0001112222100000
0011423112110000
0014432322510000
0014423232110000
0011111122100000
0000000111100000
0000000000000000
0000000000000000
0000000000000000
0000000000000000
0000000000000000
