0000000000000000
0000000000000000
0000000000000000
0000000000000000
0011110011111000
0112210012221000
0123211113221000
0122344442321000
0112222125211000
0011111111110000
0000000000000000
0000000000000000
0000000000000000
0000000000000000
0000000000000000
0000000000000000